PPPPPPPPPPPPPPPPPPPPPPPP
P   M       P        M P
P PPPPP     P PPPPPP   P
P     P     P      P   P
P V   P     P  M   P   P
P     PPPPPPP      P   P
P        M     P   P   P
P  PPPPPPPP PPPPP PPP  P
P  P     J     E       P
P  P PPPPPPPPPPPPPPPPPPP
P  P        M        V P
P  P PPPPPPPPPPPP      P
P  P M            M    P
P VPPP   P   P   PPPPPPP
P       MP   PM        P
PPPPPPPPPPPPPPPPPPPPPPPP