PPPPPPPPPPPPPPPPPPPPPPPP
P J     P     M     V  P
P PPPPP P PPPPPPPPPP P P
P P   P P     V    P P P
P P P P PPPPPPPPPP P P P
P P P P   M     P  P P P
P P PPPPPPPPPPP P PPP PP
P P         M   P   P PP
P PPPPPPPPPPPPPPPPPPP PP
P   M      P     E   P P
P PPPPPPPPP PPPPPPPPPPPP
P V     M     M       MP
P PPPPPPPPPPPPPPPPPPPP P
P   P     P  V   M   V P
P   P M   P      M     P
PPPPPPPPPPPPPPPPPPPPPPPP