PPPPPPPPPPPPPPPPPPPPPPPP
P J   M      P     M   P
P PPPPPPPPP PPPPPP PPP P
P V     P   M      P   P
P   PPPPP   PPPP P P   P
P   P    P     P P P   P
P   P M  PPPP  P P P   P
P   PPPP     PPP P PPPPP
P     M    P     P     P
P PPPPPPPP PPPPPPPPPP  P
P P   M    P     V  P  P
P PPPPPP PPP PPPPPP P  P
P M      P V     M  P  P
P PPPPPPPPPPPPPPPPPPP  P
P       E      M       P
PPPPPPPPPPPPPPPPPPPPPPPP