PPPPPPPPPPPPPPPPPPPPPPPP
PJ   P     P           P
P    P     P     M     P
P         VP    PPPPPPPP
P    PPPPPPP           P
P                 M    P
P         M            P
P                      P
P  M  PPPPP     PPPPPPPP
P         P  V     M   P
P         PE           P
P         PPPPPP       P
P    P                 P
P    P       M         P
P    P                 P
PPPPPPPPPPPPPPPPPPPPPPPP