PPPPPPPPPPPPPPPPPPPPPPPP
PJ   P     P    P     EP
P    P     P    P      P
P     M   VP    PPPPP  P
P    PPPPPPP           P
P   V M        PP M    P
P         P            P
P         P            P
P         P            P
P         P  V         P
P         P            P
P         PPPPPP       P
P                      P
P      M     M         P
P                      P
PPPPPPPPPPPPPPPPPPPPPPPP