PPPPPPPPPPPPPPPPPPPPPPPP
P   M     V     M     JP
P PPPPPPPPPPPPPPPPPPPP P
P P     P   P     P P  P
P P PPP P P P P P P P  P
P P         V P P P P  P
P P  PPPP P P P P P P  P
P P     P P P P P P P  P
P PPPPP P P P P P P P  P
P                      P
P PPPPPPPPPPPPPPPP PPPPP
P         M      E     P
P PPPPPPPPPPPPPPPPPPPPPP
P   M    V       M   V P
P         P      M     P
PPPPPPPPPPPPPPPPPPPPPPPP