PPPPPPPPPPPPPPPPPPPPPPPP
P   M     V     M     VP
P PPPPPP PPPPPPP PPPPPPP
P P     P       P     PP
P P PPP P PPPPP P PPP PP
P P P   P     P P   P PP
P P P PPPPPPP P PPPPP PP
P P P       P P     P PP
P P PPPPPPP PPPPPPPPPPPP
P P     M   P     E   PP
P P PPPPPPPPPPPPPPP   PP
P P         M         PP
P P PPPPPPPPPPPPPPPP P P
P P           M      P P
P   J               M  P
PPPPPPPPPPPPPPPPPPPPPPPP