PPPPPPPPPPPPPPPPPPPPPPPP
P J     P     M        P
P PPPPP P PPPPPPPPPP P P
P PE    P          P P P
P P   P PPPPPPPPPP P P P
P P       M     P  P P P
P P PPP  PPPPPP P PPP PP
P P         M   P   P PP
P PPPPPPPPPPPPPPPPPPP PP
P   M      P         P P
P PPPPPPPPP PPPPPPPPPPPP
P       M     M       MP
P PPPPPPPPPPPPPPPPPPPP P
P   P     P      M     P
P   P M   P      M     P
PPPPPPPPPPPPPPPPPPPPPPPP