PPPPPPPPPPPPPPPPPPPPPPPP
P J     P     M      V P
P PPPPP P PPPPPPPP PPP P
P P P   P       P      P
P P P   PPPPPPP P PPP  P
P P P       V   P P    P
P P P PPPPPPPP  P  PPPPP
P P P       M   P      P
P P PPPPPPPPPPPPPPP P  P
P       E   M       P  P
P PPPPPPPP PPPPPPPPPP PP
P   M       V     M    P
P PPPPPPPPPPPPPPPPPPPP P
P P     M     M      M P
P V   P       P   V    P
PPPPPPPPPPPPPPPPPPPPPPPP