PPPPPPPPPPPPPPPPPPPPPPPP
P J   P     M         MP
P PPP P PPPPPPPP PPPPP P
P   P          P     P P
P P P PPPPPPP P PPPPP PP
P P   M     P P     P PP
P           P PPPPP P PP
P   M     P P     P P PP
P PPPPPPP P PPPPP P P PP
P P     P P     P P P PP
P P PPP P PPPPP P P P PP
P P P   P     P P P V PP
P P PPPPPPPPP P       PP
P   P     M   P     M  P
P       E     M        P
PPPPPPPPPPPPPPPPPPPPPPPP