PPPPPPPPPPPPPPPPPPPPPPPP
P   M     V     M     VP
P PPPPPP PPPPPPP PPPPPPP
P P     P       P     PP
P P PPP P PPPPP P PPP PP
P P P   P     P P   P PP
P P P PPPPPPP P PPPPP PP
P P P       P P     P PP
P P PPPPPPP P PPPPP P PP
P P     M   P     E P PP
P P PPPPPPPPPPPPPPP P PP
P P         M       P PP
P P PPPPPPPPPPPPPPPP P P
P P     V     M      P P
P   J       P       M  P
PPPPPPPPPPPPPPPPPPPPPPPP