PPPPPPPPPPPPPPPPPPPPPPPP
PJ      P     M       EP
PP PPPP P PPPPPPPP PPPPP
P      P P        P    P
P PPPP P P PPPPPP P PP P
P P    P P P    P P P  P
P P PPPP P P PP P P P  P
P P      P P P  P P PPPP
P PPPPPPPP P P  P P    P
P     M    P P  P PPPP P
PPPPPPPPPP P PPPP    P P
P   V      P    VPPP P P
P PPPPPPPPPP PP      P P
P     M      PMMMMM    P
P        V            VP
PPPPPPPPPPPPPPPPPPPPPPPP