PPPPPPPPPPPPPPPPPPPPPPPP
P J   P     M     V   MP
P PPP P PPPPPPPP PPPPP P
P   P P     V  P     P P
P P P PPPPPPP P PPPPP PP
P P   M     P P     P PP
P PPPPPPPPP P PPPPP P PP
P   M     P P     P P PP
P PPPPPPP P PPPPP P P PP
P P     P P     P P P PP
P P PPP P PPPPP P P P PP
P P P V P     P P P   PP
P P PPPPPPPPP P PPPPPPPP
P   P     M   P     M  P
P       E     M        P
PPPPPPPPPPPPPPPPPPPPPPPP